333322222222333
332220000002223
322000000000022
320444400000002
320444440033302
320444440033302
320044440033002
220000000000002
200110000000002
211111100000002
211111111002222
211111111122222
221111111122223
322222111222233
333332222223333