3333333333322211111111111222333
3333222222200110111111111122233
3322044444400111111111111110223
3220044444400101111111101100022
3220044444400011110111110000002
3220044444400000111110000000002
3200000210000000000000000000002
3244402222044400000000011111002
3244412212244400000001111011102
3244422222244400000110111111102
3244402222044400000111111110102
3200001222000000333000111111102
2200002222200003333300011011002
2244402221200003333300001110002
2044412222212000033300000000002
2044411222222200000000000000002
2244412122222200000000444400002
3200002222222000000000044440023
3222000122220000002222004444023
3332112222222000222333220000233
3333333222222222233333322222333